SO ./textures/brick.xpm
NO ./textures/hitler.xpm
WE ./textures/stone8.xpm
EA ./textures/stone21.xpm
F 50,25,255
C 30,20,245


111111111111111111111111
100100000000000000000001
100100000001000000000001
100000010000000000000001
10000100E000000000000001
100001000000000000000001
111111111111111111111111