SO ./textures/brick.xpm
NO ./textures/hitler.xpm
WE ./textures/stone8.xpm
EA ./textures/stone21.xpm

F 255,0,0
C 30,20,245


111111111111111111111111111111111111
100000000000000000000000000000000001
100000000000000000000000000000000001
100000000000000000000000000010000001
100000000000000000000000000000000001
100000000000000000100000000000000001
111110000000000000000000000000000W01
100000000000000000000000000000000001
100000000000000000001000000000000001
100000000000000000010010000000000001
100000000000000000100001000000000001
100000000000000000000100000000000001
100000000000000000000000000000000001
111111111111111111111111111111111111