SO ./textures/brick.xpm
NO ./textures/hitler.xpm
EA ./textures/stone21.xpm
WE ./textures/stone21.xpm
F 255,0,0
C 30,20,245


11111111
111   11
11W111111
1111 10001
111111111111    