SO ./texture_south.xpm
NO ./texture_north.xpm
WE ./textures_west.xpm
EA ./texture_east.xpm
F 50,25,255
C 30,20,245


1111111111111111111111111
1000000000110000000000001
1011000001110000000000001
1001000000000000000000001
1111111110110000011100001
1000000000110000011101111
1111011111111101110000001
1111011111111101110101001
1100000011010101110000001
1000000000000000110000001
1000000000000000110101001
110000011101010111111N011
1111011100111010110111101
1111111111111111111111111








