SO ./texture_south.xpm
NO ./texture_north.xpm
WE ./textures_west.xpm
EA ./texture_east.xpm
F 50,25,255
C 30,20,245

            1
11111111111101111111111111111111111111111111
1111W1111111111111111111111111111111111111
11111111110111
1111111111111