SO ./textures/brick.xpm
NO ./textures/hitler.xpm
WE ./textures/stone8.xpm
EA ./textures/stone21.xpm

F 255,0,0
C 30,20,25


11111111111111111111111111111111111
100000000000000000000000000000000001
10000000000000000000000000000000W001
100000000000000000000000000010000001
100000000000000000000000000000000001
1000000000000000001000000000000000011111111111111111111111111
11111111111111111111111111111111111111000000000000000000001
1111111111111111111111111111111111111111111111111111111111111
100000000000000000100000000000000001
10000000000000001001000000000000001
10000000000000010001000000000000001
100000000000000010010100000000000001
100000000000000001100000000000000001
111111111111111111111111111111111111