SO .215451.xpm
NO .215451.xpm
WE .215451.xpm
EA 97.xpm
F 2,23,4
C 34,44,245

            1
11111111111101111111111111111111111111111111
1111111111111111111111111111111111111111111
111111111110111
1111111111111