SO ./textures/brick.xpm
NO ./textures/hitler.xpm
WE ./textures/stone8.xpm
EA ./textures/stone21.xpm
F 50,25,255
C 30,20,245

11111111111111
10010000000001
10010000000111
10000001000001
100001000E0001
10000100000001
11111111111111