SO ./texture_south.xpm
NO ./texture_north.xpm
WE ./textures_west.xpm
EA ./texture_east.xpm
F 50,25,255
C 30,20,245







111
101
1W111
1111









1







